{
    "name": "janitor",
    "width": 25,
    "height": 20,
    "tileWidth": 32,
    "tileHeight": 32,
    "tileDefinitions": {
        ".": { "type": "empty", "solid": false, "color": "#222222" },
        "#": { "type": "wall", "solid": true, "color": "#666666" }
    },
    "playerSpawn": { "x": 12, "y": 3 },
    "layers": {
        "background": [
            "#########################",
            "#.......................#",
            "#.......................#",
            "#.......................#",
            "#.......................#",
            "#.......................#",
            "#.......................#",
            "#.......................#",
            "#.......................#",
            "#.......................#",
            "#####...#########...#####",
            "#...........#...........#",
            "#...........#...........#",
            "#...........#...........#",
            "#...........#...........#",
            "#...........#...........#",
            "#...........#...........#",
            "#...........#...........#",
            "#...........#...........#",
            "#########################"
        ],
        "foreground": [
            ".........................",
            ".........................",
            ".........................",
            ".........................",
            ".........................",
            ".........................",
            ".........................",
            ".........................",
            ".........................",
            ".........................",
            ".........................",
            ".........................",
            ".........................",
            ".........................",
            ".........................",
            ".........................",
            ".........................",
            ".........................",
            ".........................",
            "........................."
        ]
    }
}
