{
    "name": "Level 1",
    "width": 20,
    "height": 15,
    "tileWidth": 32,
    "tileHeight": 32,
    "tileSet": {
        ".": { "name": "grass", "solid": false },
        "#": { "name": "wall", "solid": true },
        "~": { "name": "water", "solid": true },
        "T": { "name": "tree", "solid": true },
        "S": { "name": "stone", "solid": false },
        "P": { "name": "player_spawn", "solid": false }
    },
    "layers": {
        "background": [
            "#..................#",
            "#..................#",
            "####################",
            "#....T.............#",
            "#..................#",
            "#......~~~~........#",
            "#......~~~~........#",
            "#......~~~~........#",
            "#..................#",
            "#........P.........#",
            "#..................#",
            "#....S.............#",
            "#..................#",
            "#..................#",
            "####################"
        ],
        "foreground": [
            "....................",
            "....................",
            "....................",
            "....................",
            "....................",
            "....................",
            "....................",
            "....................",
            "....................",
            "....................",
            "....................",
            "....................",
            "....................",
            "....................",
            "...................."
        ]
    }
}
